==================================================.
S |       |             |     |     |         |   |
| '=====. | ==========. | | .=' | | | ==. .== | | |
|       |     |       |   | |   | | |   | |   | | |
|=====. |===. '====== |===| | .=' | '===' | .=' | |
|     | |   |         |   |   |   |       | |   | |
| .===| | | '=========' | |===| ==+=======| '== | |
| |   |   |     |       | |   |   |       |     | |
| | | '===+===. | .=====| | | | | '=. .== '=====' |
|   |     |   |   |   | |   | | |   | |     |     |
|===' .== '== '===| | | '===| '===. |=' .== | ====|
|     |           | | |     |     | |   |   |   | |
| .===' .=======. | | | .== |===. | | | |=====. | |
| |     |   |   | | |   |   |   |   | | |     |   |
| '=====' | | | | | |===' .=' | '===' |=' .=. '=. |
|     |   |   | |   |     |   |       |   | |   | |
| .=. | ======| '===+=====| .=====. ==| ==| | | | |
| | | |       |     |     | |     |   |   | | | | |
| | | '====== '===. | ==. | | .== '=. '== | | '=' |
|   |             |     |     |     |       |     E
'==================================================