==================================================.
S.|       |             |     |  ...|    .....|...|
|.'=====. | ==========. | | .=' |.|.| ==...==.|.|.|
|.......|     |       |   | |   |.|.|   |.|...|.|.|
|=====..|===. '====== |===| | .='.|.'==='.|..='.|.|
|     |.|...|         |...|   |...|.......|.|  .|.|
| .===|.|.|.'========='.|.|===|.==+=======|.'==.|.|
| |   |...|.....|.......|.|...|...|       |.....|.|
| | | '===+===..|..=====|.|.|.| |.'=. .== '====='.|
|   |     |   |...|   | |...|.| |...| |     |.....|
|===' .== '== '===| | | '===|.'===..|=' .== |.====|
|     |           | | |     |.....|.|   |   |...| |
| .===' .=======. | | | .== |===..|.| | |=====..| |
| |     |   |   | | |   |   |   |...| | |     |...|
| '=====' | | | | | |===' .=' | '===' |=' .=. '=..|
|     |   |   | |   |     |   |       |   | |   |.|
| .=. | ======| '===+=====| .=====. ==| ==| | | |.|
| | | |       |     |     | |     |   |   | | | |.|
| | | '====== '===. | ==. | | .== '=. '== | | '='.|
|   |             |     |     |     |       |    .E
'==================================================